  ###########
 ##         #
 #   $ $ $@ #
##  #### ####
# $ # ..... #
#   ####  ###
###     $   #
 ######   ###
      #######
1234567890123