  #####
 #    #
#  * +#
#  * *##
###  $ #
   #   #
   #####
12345678