 ######
##    #
#  * +#
#  * *##
###  $ #
  ##   #
   #####
12345678