      ####
#######  ######
# $ $ $ $ $ $ #
# ...  @  ... #
# ########### #
#             #
###############
123456789012345