       ####
    ####  ##
    #      #
    # $#...#
#####  #..##
# $  $$ $ #
#  @    ###
#########
1234567890