#######
#      #
#  $  #.#
#..#$@# .#
#  $    .##
##$##$   #
#      ##
########
1234567890