#####
#  @#
# #$.##
#  $.  #
#  $.  #
########
12345678