#####
#  @##
# #$.###
#  $.  #
#  $.  #
########
12345678